NO ./textures/1.xpm
SO ./textures/2.xpm
WE ./textures/3.xpm
EA ./textures/4.xpm

F 0,51,0
C 28,160,201

11111111111111111111111111111111111111111111111111111
11110000000011111111000011000001111000E0000000001
111100000001111111110001100000011111000000000101111
111100000000000000000011111000111000000111001111
11110000000000000100000111110001111000001110000111
1111000000000000000111111000001111000001110001111
1111111111111110000000011000000000000000000011111
110000000000000000000001101100000000000001111
11000000000000000001111110001100000011100001
1000011110000000001111011000000000111000011111
10000111100011110000000110011110000011100001
100000010000111100000001100011110000000000001
10000000000000000001111110001100000011100011
10000111100000000001111110000000000011111001111
110000010100001111000001100011110000011100001
11111111111111111111111111111111111111111111


