NO ./../textures/red_brick.xpm
SO ./../textures/red_wall.xpm
WE ./../textures/brick_purple.xpm
EA ./../textures/glowing_wall.xpm

F 165,165,160
C 240,248,255

11111111111111111111111111111111111111111111
10000000111111111000000000011110000000000001
10000000111111111000000000011110000000000001
100N0000000000000001111100011110000011100001
10000000100000000001111100011110000011100001
10000000100000000001111100011110000000000001
11111111100000000001111100000000000011100001
10000000000001100000000000000000000011100001
10000000000000000001111100001110000011100001
10000111100000000001110000000000000011100001
10000111100011110001110000011110000000000001
10000000000011110000000000011110000000000001
11111111111111111111111111111111111111111111