NO ./textures/wall1.xpm
SO ./textures/wall2.xpm
WE ./textures/wall1.xpm
EA ./textures/wall2.xpm

F 165,165,160
C 320,328,255

11111111111111111111111111111111111111111111
10000000111111110000000000011110000000000001
10000000111111110000000000011110000000000001
100N0000000000000001111100011110000011100001
10000000100000000001111100011110000011100001
10000000100000000001111100011110000011100001
11111111100000000000000000000000000000000001
10000000000000000000000000001100000000000001
10000000000000000001111100001100000011100001
10000111100000000001111100000000000011100001
10000000000011110000000000011110000011100001
10000000000011110000000000011110000000000001
11111111111111111111111111111111111111111111